5 7
4 0
4 3
*   ***
* *   *
*   * *
* *   *
  * ***
  